225 26 325
7 8
175 475
1 1 1 1 1 1 1 1
1 -2 1 1 1 1 1 1
1 0 0 0 2 3 1 -3
1 0 0 0 0 0 0 -1
1 0 0 0 0 1 1 -3
1 1 1 1 1 1 1 1
1 1 1 1 1 1 1 1
0
