275 26 325
8 9
175 525
1 1 1 1 1 1 1 1 1
1 1 1 1 1 1 1 1 1
1 1 -2 1 1 1 1 1 1
1 1 0 0 0 2 3 1 1
1 1 0 0 0 0 0 0 -1
1 1 0 0 0 1 1 1 1
1 1 1 1 1 1 1 1 1
1 1 1 1 1 1 1 1 1
0