175 26 325
7 11
175 475
1 1 1 1 1 1 1 1 1 1 1
1 1 1 0 0 0 0 0 1 1 1
1 1 1 0 0 0 0 0 1 1 1
0 0 0 0 1 4 1 1 1 1 1
1 1 1 2 1 4 1 1 1 1 1
1 1 1 -2 3 0 0 0 -1 1 1
1 1 1 1 1 1 1 1 1 1 1
2
375 30 375
475 30 375