175 26 325
7 11
175 475
1 1 1 1 1 1 1 1 1 1 1
1 1 1 0 0 0 0 0 1 1 1
1 1 1 0 5 0 5 0 1 1 1
0 0 0 0 1 6 1 1 1 1 1
1 1 1 3 1 6 1 1 1 1 1
1 1 1 -2 4 0 0 0 -1 1 1
1 1 1 1 1 1 1 1 1 1 1