175 26 425
10 11
75 625
1 1 1 1 1 1 1 1 1 1 1 
1 1 1 1 1 1 1 1 1 1 1 
1 1 1 1 1 1 1 1 1 1 1 
1 7 0 0 0 3 0 1 1 1 1
1 1 0 5 5 1 4 0 0 0 -1
1 1 0 0 0 1 6 1 1 1 1
1 1 1 8 1 1 5 1 1 1 1
1 1 1 8 1 1 -2 1 1 1 1
1 1 1 8 8 8 0 1 1 1 1
1 1 1 1 1 1 1 1 1 1 1
