175 26 425
10 11
75 625
1 1 1 1 1 1 1 1 1 1 1 
1 1 1 1 1 1 1 1 1 1 1 
1 1 1 1 1 1 1 1 1 1 1 
1 5 0 0 0 2 0 1 1 1 1
1 1 0 0 0 1 3 0 0 0 -1
1 1 0 0 0 1 4 1 1 1 1
1 1 1 6 1 1 0 1 1 1 1
1 1 1 6 1 1 -2 1 1 1 1
1 1 1 6 6 6 0 1 1 1 1
1 1 1 1 1 1 1 1 1 1 1
3
225 30 425
275 30 425
375 30 325