225 26 375
11 11
125 625
1 1 1 1 1 1 1 1 1 1 1
1 1 1 1 1 1 1 1 1 1 1
1 1 1 1 1 1 1 1 1 1 1
1 1 0 0 0 0 1 1 1 1 1
1 1 0 0 0 0 1 1 1 1 -3
1 1 0 0 0 0 2 2 -2 3 -1
1 1 0 0 0 0 1 1 1 1 -3
1 1 0 0 0 0 1 1 1 1 1
1 1 1 1 1 1 1 1 1 1 1
1 1 1 1 1 1 1 1 1 1 1
1 1 1 1 1 1 1 1 1 1 1
4
325 30 375
375 30 375
375 30 325
375 30 425
