175 26 375
6 7
75 475
1 1 1 1 1 1 1
1 5 0 0 3 1 1
1 0 1 0 0 1 -1
1 0 2 0 0 1 1
1 0 6 6 6 0 1
1 0 0 0 0 0 1
1
175 -40 375
175 10 375
175 60 375
175 110 375