325 76 375
6 7
75 475
1 1 1 1 1 1 1
1 5 0 0 3 1 1
1 0 0 0 0 1 -1
1 0 0 0 0 1 1
1 0 6 6 6 0 1
1 0 0 0 0 0 1
3
325 -40 375
325 10 375
325 60 375