225 26 375
11 11
125 625
1 1 1 1 1 1 1 1 1 1 1
1 1 1 1 1 1 1 1 1 1 1
1 1 1 1 1 1 1 1 1 1 1
1 1 0 0 0 0 1 1 1 1 1
1 1 0 0 8 0 1 1 1 1 -3
1 1 0 0 7 0 -2 0 0 3 -1
1 1 0 0 8 0 1 1 1 1 -3
1 1 0 0 0 0 1 1 1 1 1
1 1 9 0 1 1 1 1 1 1 1
1 1 1 1 1 1 1 1 1 1 1
1 1 1 1 1 1 1 1 1 1 1
1
275 30 375
