175 26 375
9 14
75 575
1 1 1 1 1 1 1 1 1 1 1 1 1 1
1 1 1 1 1 1 1 1 1 1 1 1 1 1
1 1 0 0 0 0 0 1 1 1 1 1 1 1
1 1 0 0 0 0 0 0 1 1 1 1 1 -3
1 1 0 0 5 5 6 6 0 0 0 -2 0 -1
1 1 0 0 0 0 0 0 1 1 1 1 1 -3
1 1 0 0 0 0 0 1 1 1 1 1 1 1
1 1 1 1 1 1 1 1 1 1 1 1 1 1
1 1 1 1 1 1 1 1 1 1 1 1 1 1
5
225 30 375
225 30 425
225 30 325
475 30 375
525 30 375