175 26 375
9 10
75 575
1 1 1 1 1 1 1 1 1 1
1 1 1 1 1 1 1 1 1 1
1 1 0 0 0 1 1 1 1 1
1 1 0 0 0 4 -2 1 1 -3
1 1 0 6 0 5 4 0 0 -1
1 1 0 0 0 4 3 1 1 -3
1 1 0 0 0 1 1 1 1 1
1 1 1 1 1 1 1 1 1 1
1 1 1 1 1 1 1 1 1 1
4
275 30 425
275 30 325
225 -20 375
225 35 375