275 26 325
8 9
175 525
1 1 1 1 1 1 1 1 1
1 1 1 1 1 1 1 1 1
1 1 -2 1 1 1 1 1 1
1 1 0 0 5 3 4 1 1
1 1 0 5 0 0 0 0 -1
1 1 0 0 0 1 1 1 1
1 1 1 1 1 1 1 1 1
1 1 1 1 1 1 1 1 1