325 26 325
6 8
225 475
1 1 1 1 1 1 1 1
1 2 1 1 1 1 1 1
1 0 5 0 3 4 1 1
1 0 0 0 0 0 0 -1
1 0 0 0 1 1 1 1
1 1 1 1 1 1 1 1